敌空墙墙墙空墙墙墙墙空空敌
空空空空墙钢空钢空钢空墙墙
墙空空空空空空空空空空墙墙
墙空空空空钢水钢水钢水钢空
墙墙墙墙墙墙空墙空墙空墙空
空空空空空空空空空空空空空
空空钢钢钢钢钢钢钢钢钢空空
墙墙墙墙墙墙墙墙墙墙墙墙墙
墙墙墙墙墙墙墙墙墙墙墙墙墙
墙墙墙墙墙墙墙墙墙墙墙墙墙
空空空空空空空空空空空空空
空空空空空空空空空空空空空
